//####///
###   ###
#     $ #
# #  #$ #
# . .#@ #
#########